############
#....##....#
#......@...#
###.##.#...#
#...#..#...#
#..#...#..##
#...##.....#
#.......####
############